111111111111111111111111111111111111111
1P00000C000000000C00000000000C000000001
1000C00000C00000000000C0000000000C00001
10C0000C0000000C0000C000000C0000000C001
1000C00000C00000000000C0000000000C00001
100000C000000000000C0000000C0000000C001
1000C00000C00000000000C0000000000C00001
10C0000C0000000C0000C000000C0000000C001
1000C00000C00000000000C0000000000C00001
100000C000000000000C0000000C0000000C001
1000C00000C00000000000C0000000000C00001
10C0000C0000000C0000C000000C0000000C001
1000C00000C00000000000C0000000000C00001
100000C000000000000C0000000C0000000C001
1000C00000C00000000000C0000000000C00001
10C0000C0000000C0000C000000C0000000C001
1000C00000C00000000000C0000000000C00001
100000C000000000000C0000000C00000000001
10000000000000000000000000000000000C0E1
111111111111111111111111111111111111111