11111111111111111111
1P000000C000C0000001
100C0000000C00C00001
1C00000C0000000C0001
100C000000C0000C0001
1000C00C00000C000001
100000000C00000C0001
1C0C00C00000C000C001
10000000000000000CE1
11111111111111111111