1111111111
1P00C000C1
100000C001
1C0000C001
100000C0E1
1111111111