1111111
1E00101
1C001P1
1111111