11111111111111111111111111111111111111111111111111111111111111111111111111111
1P0000000C00000C000000000000000C00000C000000000000000C00000C00000000000000001
100000C0000000000C00000000C0000000000000C00000000C0000000000000C000000000C001
100000000C00000C000000000000000C00000C000000000000000C00000C00000000000000001
100000C0000000000C00000000C0000000000000C00000000C0000000000000C000000000C001
100000000C00000C000000000000000C00000C000000000000000C00000C00000000000000001
100000C0000000000C00000000C0000000000000C00000000C0000000000000C000000000C001
100000000C00000C000000000000000C00000C000000000000000C00000C00000000000000001
100000C0000000000C00000000C0000000000000C00000000C0000000000000C000000000C001
100000000C00000C000000000000000C00000C000000000000000C00000C00000000000000001
100000C0000000000C00000000C0000000000000C00000000C0000000000000C000000000C001
100000000C00000C000000000000000C00000C000000000000000C00000C00000000000000001
100000C0000000000C00000000C0000000000000C00000000C0000000000000C000000000C001
100000000C00000C000000000000000C00000C000000000000000C00000C00000000000000001
100000C0000000000C00000000C0000000000000C00000000C0000000000000C000000000C001
100000000C00000C000000000000000C00000C000000000000000C00000C00000000000000001
100000C0000000000C00000000C0000000000000C00000000C0000000000000C000000000C001
100000000C00000C000000000000000C00000C000000000000000C00000C00000000000000001
100000C0000000000C00000000C0000000000000C00000000C0000000000000C000000000C001
100000000C00000C000000000000000C00000C000000000000000C00000C00000000000000001
100000C0000000000C00000000C0000000000000C00000000C0000000000000C000000000C001
100000000C00000C000000000000000C00000C000000000000000C00000C00000000000000001
100000C0000000000C00000000C0000000000000C00000000C0000000000000C000000000C001
100000000C00000C000000000000000C00000C000000000000000C00000C00000000000000001
100000C0000000000C00000000C0000000000000C00000000C0000000000000C000000000C001
100000000C00000C000000000000000C00000C000000000000000C00000C000000000000000E1
11111111111111111111111111111111111111111111111111111111111111111111111111111