1111111111111
10000E0C000C1
1101111101111
1P000100000C1
1111111111111