1111111111111
1000000C000C1
1101111101111
1P0011E000001
1111111111111